1111111111
1000000001
1011111101
1010000101
1010110101
1000000001
1111111111
